07 07 07 07 07 07 07 07 07 07
07 00 00 00 00 00 00 00 00 07
07 00 00 00 00 00 00 00 00 07
07 00 00 00 00 00 00 00 00 07
07 00 00 00 00 00 00 00 00 07
07 00 00 00 00 00 00 00 00 07
07 00 00 00 07 07 07 07 07 07
07 00 00 00 05 00 03 00 00 07
07 08 00 00 05 00 03 00 80 07
07 07 07 07 07 07 07 07 07 07
